1111111111111111111111111111111111
102000000000000C00000C0000000000E1
1010010100100000101001000000010101
1C10010010101010001001111111111111
100002000C00C0000000000000000000C1
100000000000000C000000001111110001
1010010100100000111110000000C1C101
111111111111111110C011111111111101
1P0000P00C00C0000020000000000000C1
1111111111111111111111111111111111