1111111111111111111111111111111111
102000000200000C00000C0002000000E1
101001010010000010100100000CC10101
1C10010010101010001001111111111111
100002000C00C0000020000000000000C1
102000002000000C002000001111110001
1000010111110000111110000000C1C101
111111111CCC111110C011111111111101
1P0000P00C0CC0000020000000000000C1
1111111111111111111111111111111111