1111111111111111111111111111111111
1E0001000000000C00000C000000000001
1010000111100000101001000200010101
1011110020101010001001000000010101
1P0000000C00C0000000020000020000C1
1111111111111111111111111111111111