11111111111111111111111111111111111111111111111111111111111
1P000000C00000000000000000000C10000000000010000000000000001
10000000000000000000100000000010000000000010000001000020001
10000000000000020000100000200010000000000010000001000000001
1C00000000000000C000100000000000000000000010000001000000C01
11111111111111111111111111111110000200000010000201111111111
10000000000000000100000000000000000000000010000000000000001
100C000000000000010C000000000000000000000010000000200000C01
10000000000000000111111111100000002000000010000000000000001
10000000000020000100000000000000000000000010001111111111111
10000000000000000100000000000000000000000010000000000000001
10000000000000000100000000000000000000000C10000000000000001
11111111111100000100000200000000001111111110000000000000001
10000000C0010020010000000000000000100C000010000000000200001
10002000000100000000000000000000001000200010000000000000001
10001111111100000000020000000000001000000010000000000000001
10000000000000000000000000000000001000000000000000000000001
100000000000000000000000000000000000000000000000000000000E1
10111111111111111111111111111111111111111111111111111111011
10111111111111111111111111111111111111111111111111111111011
1P000000C00000000000000000000C10000000000010000000000000001
10000000000000000000100000000010000000000010000001000020001
10000000000000020000100000200010000000000010000001000000001
1C00000000000000C000100000000000000000000010000001000000C01
11111111111111111111111111111110000200000010000201111111111
10000000000000000100000000000000000000000010000000000000001
100C000000000000010C000000000000000000000010000000200000C01
10000000000000000111111111100000002000000010000000000000001
10000000000020000100000000000000000000000010001111111111111
10000000000000000100000000000000000000000010000000000000001
10000000000000000100000000000000000000000C10000000000000001
11111111111100000100000200000000001111111110000000000000001
10000000C0010020010000000000000000100C000010000000000200001
10002000000100000000000000000000001000200010000000000000001
10001111111100000000020000000000001000000010000000000000001
10000000000000000000000000000000001000000000000000000000001
100000000000000000000000000000000000000000000000000000000E1
11111111111111111111111111111111111111111111111111111111111