11111111111111111111111111111111111111111111111111111111111111111111111111111111111111111111
1P000000C00000000000000000000010000000000010000000000000000100000000000000000000000000000001
10000000000000000000100000000010000000000010000001000020000100000000000000000010000000000001
10000000000000020000100000200010000000000010000001000000000100010002000000000011111111111111
1000000000000000C000100000000000000000000010000001000000C00100010000000000000000000000000001
11111111111111111111111111111110000200000010000201111111111100011111000200000000000000000001
10000000000000000100000000000000000000000010000000000000000102000001000000000020000000000001
100C0000000000000100000000000000000000000010000000200000C00100002001000000000000000002000001
10000000000000000100000000000000002000000010000000000000000100000C01000000000000000000000001
10000000000020000100000000000000000000000010001111111111111111111111111111111111111111102001
10000000000000000100000000000000000000000010000000000000000000000000000000100000000000000001
10000000000000000100000000000000000000000010000000000000000000000000000000100020020020000001
11111111111100000100000200000000001111111110000000000000000000000100000000100000000000000001
10000000C0010020010000000000000000100C000010000000000200000000000100000000100000000000000001
10002000000100000000000000000000001000200010000000000000000000000100000000000000000000000001
10001111111100000000020000000000001000000010000000000000000110200111111111111111111111111111
10000000000000000000000000000000001000000000000000000000000100000100000000000200000000000001
100000000000000000000000000000000000000000000000000000000001000000000000020000000000000000E1
11111111111111111111111111111111111111111111111111111111111111111111111111111111111111111111