1111111111111111111111111111111111111111111
1P000000C0000000000000000000001000000000001
1000000000000000000010000000001000000000001
1000000000000002000010000020001000000000001
1000000000000000C00010000000000000000000001
1111111111111111111111111111111000020000001
1000000000000000010000000000000000000000001
100C000000000000010000000000000000000000001
1000000000000000010000000000000000200000001
1000000000002000010000000000000000000000001
1000000000000000010000000000000000000000001
1000000000000000010000000000000000000000001
1111111111110000010000020000000000111111111
10000000C0010020010000000000000000100C00001
1000200000010000000000000000000000100020001
100011111111000000000200000000000010E000001
1000000000000000000000000000000000102000001
1000000000000000000000000000000000100002001
1000011111111111111111111111111111100200001
1000010000200100C001000000000010C0100000001
10000100C0010000200100001000001200100000001
1000011111111100000200001000001000000000001
1000000000000111111111111002001000210200001
10000000000000000000000000000000000100C0001
1111111111111111111111111111111111111111111