111111111
1P0000001
1000C0001
1000000E1
111111111