111111111
1P0000001
10000C001
1000000E1
111111111